STATE_NAME,Lg_Dist_Code,DISTRICT_NAME,MICRO,SMALL,MEDIUM,Total,Last_Updated
ANDHRA PRADESH,502,ANANTHAPUR,7797,238,10,8045,2022-01-11
ANDHRA PRADESH,503,CHITOOR,9623,351,19,9993,2022-01-11
ANDHRA PRADESH,505,EAST GODAVARI,12347,615,49,13011,2022-01-11
ANDHRA PRADESH,506,GUNTUR,11386,630,53,12069,2022-01-11
ANDHRA PRADESH,510,KRISHNA,15189,1007,79,16275,2022-01-11
ANDHRA PRADESH,511,KURNOOL,8972,348,16,9336,2022-01-11
ANDHRA PRADESH,517,PRAKASAM,6527,231,7,6765,2022-01-11
ANDHRA PRADESH,515,SPSR NELLORE,7515,351,19,7885,2022-01-11
ANDHRA PRADESH,519,SRIKAKULAM,2989,98,6,3093,2022-01-11
ANDHRA PRADESH,520,VISAKHAPATNAM,13102,941,78,14121,2022-01-11
ANDHRA PRADESH,521,VIZIANAGARAM,3093,130,3,3226,2022-01-11
ANDHRA PRADESH,523,WEST GODAVARI,10450,586,68,11104,2022-01-11
ANDHRA PRADESH,504,Y.S.R,6330,273,15,6618,2022-01-11
ARUNACHAL PRADESH,628,ANJAW,17,0,0,17,2022-01-11
ARUNACHAL PRADESH,229,CHANGLANG,70,0,0,70,2022-01-11
ARUNACHAL PRADESH,230,DIBANG VALLEY,5,0,0,5,2022-01-11
ARUNACHAL PRADESH,231,EAST KAMENG,18,0,0,18,2022-01-11
ARUNACHAL PRADESH,232,EAST SIANG,65,0,0,65,2022-01-11
ARUNACHAL PRADESH,718,KAMLE,3,0,0,3,2022-01-11
ARUNACHAL PRADESH,677,KRA DAADI,7,0,0,7,2022-01-11
ARUNACHAL PRADESH,233,KURUNG KUMEY,11,1,0,12,2022-01-11
ARUNACHAL PRADESH,724,LEPARADA,4,0,0,4,2022-01-11
ARUNACHAL PRADESH,234,LOHIT,81,0,0,81,2022-01-11
ARUNACHAL PRADESH,666,LONGDING,7,0,0,7,2022-01-11
ARUNACHAL PRADESH,235,LOWER DIBANG VALLEY,31,0,0,31,2022-01-11
ARUNACHAL PRADESH,719,LOWER SIANG,13,0,0,13,2022-01-11
ARUNACHAL PRADESH,236,LOWER SUBANSIRI,141,2,0,143,2022-01-11
ARUNACHAL PRADESH,678,NAMSAI,17,0,0,17,2022-01-11
ARUNACHAL PRADESH,723,PAKKE KESSANG,4,0,0,4,2022-01-11
ARUNACHAL PRADESH,237,PAPUM PARE,483,36,6,525,2022-01-11
ARUNACHAL PRADESH,725,SHI YOMI,4,0,0,4,2022-01-11
ARUNACHAL PRADESH,679,SIANG,7,0,0,7,2022-01-11
ARUNACHAL PRADESH,238,TAWANG,23,2,0,25,2022-01-11
ARUNACHAL PRADESH,239,TIRAP,30,1,0,31,2022-01-11
ARUNACHAL PRADESH,240,UPPER SIANG,12,1,0,13,2022-01-11
ARUNACHAL PRADESH,241,UPPER SUBANSIRI,32,2,0,34,2022-01-11
ARUNACHAL PRADESH,242,WEST KAMENG,79,5,0,84,2022-01-11
ARUNACHAL PRADESH,243,WEST SIANG,37,3,0,40,2022-01-11
ASSAM,616,BAKSA,714,6,1,721,2022-01-11
ASSAM,280,BARPETA,1606,47,4,1657,2022-01-11
ASSAM,705,Biswanath,519,16,0,535,2022-01-11
ASSAM,281,BONGAIGAON,784,32,3,819,2022-01-11
ASSAM,282,CACHAR,2331,105,5,2441,2022-01-11
ASSAM,708,CHARAIDEO,199,9,0,208,2022-01-11
ASSAM,612,CHIRANG,496,13,3,512,2022-01-11
ASSAM,283,DARRANG,4249,42,0,4291,2022-01-11
ASSAM,284,DHEMAJI,1343,20,0,1363,2022-01-11
ASSAM,285,DHUBRI,1007,27,1,1035,2022-01-11
ASSAM,286,DIBRUGARH,2107,138,4,2249,2022-01-11
ASSAM,299,DIMA HASAO,146,0,0,146,2022-01-11
ASSAM,287,GOALPARA,810,23,1,834,2022-01-11
ASSAM,288,GOLAGHAT,1477,43,1,1521,2022-01-11
ASSAM,289,HAILAKANDI,603,12,0,615,2022-01-11
ASSAM,709,HOJAI,543,21,1,565,2022-01-11
ASSAM,290,JORHAT,1292,115,7,1414,2022-01-11
ASSAM,291,KAMRUP,2278,70,10,2358,2022-01-11
ASSAM,618,KAMRUP METRO,6455,983,125,7563,2022-01-11
ASSAM,292,KARBI-ANGELONG,641,11,0,652,2022-01-11
ASSAM,293,KARIMGANJ,1138,41,0,1179,2022-01-11
ASSAM,294,KOKRAJHAR,539,18,0,557,2022-01-11
ASSAM,295,LAKHIMPUR,1110,44,3,1157,2022-01-11
ASSAM,706,MAJULI,142,1,0,143,2022-01-11
ASSAM,296,MARIGAON,887,10,1,898,2022-01-11
ASSAM,297,NAGAON,1826,58,4,1888,2022-01-11
ASSAM,298,NALBARI,921,25,1,947,2022-01-11
ASSAM,300,SIVASAGAR,932,74,5,1011,2022-01-11
ASSAM,301,SONITPUR,1532,62,11,1605,2022-01-11
ASSAM,707,SOUTH SALMARA MANCACHAR,81,2,0,83,2022-01-11
ASSAM,302,TINSUKIA,1638,106,9,1753,2022-01-11
ASSAM,617,UDALGURI,600,8,0,608,2022-01-11
ASSAM,710,WEST KARBI ANGLONG,105,0,0,105,2022-01-11
BIHAR,188,ARARIA,3734,102,3,3839,2022-01-11
BIHAR,611,ARWAL,579,17,0,596,2022-01-11
BIHAR,189,AURANGABAD,2420,55,3,2478,2022-01-11
BIHAR,190,BANKA,2999,24,1,3024,2022-01-11
BIHAR,191,BEGUSARAI,5356,139,12,5507,2022-01-11
BIHAR,192,BHAGALPUR,6246,145,9,6400,2022-01-11
BIHAR,193,BHOJPUR,2880,55,1,2936,2022-01-11
BIHAR,194,BUXAR,1827,49,1,1877,2022-01-11
BIHAR,195,DARBHANGA,5737,125,5,5867,2022-01-11
BIHAR,196,GAYA,6595,119,10,6724,2022-01-11
BIHAR,197,GOPALGANJ,3512,54,1,3567,2022-01-11
BIHAR,198,JAMUI,2563,57,0,2620,2022-01-11
BIHAR,199,JEHANABAD,1301,12,0,1313,2022-01-11
BIHAR,200,KAIMUR (BHABUA),1322,31,1,1354,2022-01-11
BIHAR,201,KATIHAR,4376,122,3,4501,2022-01-11
BIHAR,202,KHAGARIA,2803,41,1,2845,2022-01-11
BIHAR,203,KISHANGANJ,2117,45,4,2166,2022-01-11
BIHAR,204,LAKHISARAI,1314,24,0,1338,2022-01-11
BIHAR,205,MADHEPURA,2513,43,1,2557,2022-01-11
BIHAR,206,MADHUBANI,6316,82,1,6399,2022-01-11
BIHAR,207,MUNGER,2484,20,0,2504,2022-01-11
BIHAR,208,MUZAFFARPUR,10704,312,20,11036,2022-01-11
BIHAR,209,NALANDA,3845,77,2,3924,2022-01-11
BIHAR,210,NAWADA,2863,52,2,2917,2022-01-11
BIHAR,211,PASHCHIM  CHAMPARAN,4291,105,1,4397,2022-01-11
BIHAR,212,PATNA,24416,970,105,25491,2022-01-11
BIHAR,213,PURBI  CHAMPARAN,7909,126,5,8040,2022-01-11
BIHAR,214,PURNIA,6392,240,27,6659,2022-01-11
BIHAR,215,ROHTAS,3609,86,3,3698,2022-01-11
BIHAR,216,SAHARSA,2670,53,3,2726,2022-01-11
BIHAR,217,SAMASTIPUR,7208,138,5,7351,2022-01-11
BIHAR,218,SARAN,5000,85,2,5087,2022-01-11
BIHAR,219,SHEIKHPURA,1033,14,0,1047,2022-01-11
BIHAR,220,SHEOHAR,1144,8,0,1152,2022-01-11
BIHAR,221,SITAMARHI,4840,72,2,4914,2022-01-11
BIHAR,222,SIWAN,3774,70,3,3847,2022-01-11
BIHAR,223,SUPAUL,2803,37,4,2844,2022-01-11
BIHAR,224,VAISHALI,6340,102,4,6446,2022-01-11
CHHATTISGARH,646,BALOD,1163,19,3,1185,2022-01-11
CHHATTISGARH,644,BALOD BAZAR,2411,48,1,2460,2022-01-11
CHHATTISGARH,649,BALRAMPUR,691,4,1,696,2022-01-11
CHHATTISGARH,374,BASTAR,1179,39,3,1221,2022-01-11
CHHATTISGARH,650,BEMETARA,1362,18,0,1380,2022-01-11
CHHATTISGARH,636,BIJAPUR,136,0,0,136,2022-01-11
CHHATTISGARH,375,BILASPUR,5824,280,20,6124,2022-01-11
CHHATTISGARH,376,DANTEWADA,288,10,0,298,2022-01-11
CHHATTISGARH,377,DHAMTARI,1346,40,0,1386,2022-01-11
CHHATTISGARH,378,DURG,6702,316,32,7050,2022-01-11
CHHATTISGARH,645,GARIABAND,638,4,0,642,2022-01-11
CHHATTISGARH,734,Gaurella Pendra Marwahi,190,1,0,191,2022-01-11
CHHATTISGARH,379,JANJGIR-CHAMPA,2823,71,2,2896,2022-01-11
CHHATTISGARH,380,JASHPUR,658,27,2,687,2022-01-11
CHHATTISGARH,382,KABIRDHAM,1107,34,2,1143,2022-01-11
CHHATTISGARH,381,KANKER,1194,17,2,1213,2022-01-11
CHHATTISGARH,643,KONDAGAON,551,7,0,558,2022-01-11
CHHATTISGARH,383,KORBA,3427,168,29,3624,2022-01-11
CHHATTISGARH,384,KOREA,1152,28,0,1180,2022-01-11
CHHATTISGARH,385,MAHASAMUND,1846,43,1,1890,2022-01-11
CHHATTISGARH,647,MUNGELI,827,10,0,837,2022-01-11
CHHATTISGARH,637,NARAYANPUR,105,1,0,106,2022-01-11
CHHATTISGARH,386,RAIGARH,3340,188,16,3544,2022-01-11
CHHATTISGARH,387,RAIPUR,13764,1127,132,15023,2022-01-11
CHHATTISGARH,388,RAJNANDAGAON,3030,93,3,3126,2022-01-11
CHHATTISGARH,642,SUKMA,132,4,0,136,2022-01-11
CHHATTISGARH,648,SURAJPUR,1117,32,0,1149,2022-01-11
CHHATTISGARH,389,SURGUJA,1902,97,8,2007,2022-01-11
GOA,551,NORTH GOA,5110,243,25,5378,2022-01-11
GOA,552,SOUTH GOA,3853,185,15,4053,2022-01-11
GUJARAT,438,AHMADABAD,67171,3249,426,70846,2022-01-11
GUJARAT,439,AMRELI,2434,92,2,2528,2022-01-11
GUJARAT,440,ANAND,6590,150,9,6749,2022-01-11
GUJARAT,672,ARVALLI,1777,62,1,1840,2022-01-11
GUJARAT,441,BANAS KANTHA,6014,234,19,6267,2022-01-11
GUJARAT,442,BHARUCH,7851,435,21,8307,2022-01-11
GUJARAT,443,BHAVNAGAR,8376,235,25,8636,2022-01-11
GUJARAT,676,BOTAD,963,32,2,997,2022-01-11
GUJARAT,668,CHHOTAUDEPUR,870,17,1,888,2022-01-11
GUJARAT,444,DANG,158,5,0,163,2022-01-11
GUJARAT,674,DEVBHOOMI DWARKA,1669,69,3,1741,2022-01-11
GUJARAT,445,DOHAD,1665,52,7,1724,2022-01-11
GUJARAT,446,GANDHINAGAR,7013,233,16,7262,2022-01-11
GUJARAT,675,GIR SOMNATH,2043,94,1,2138,2022-01-11
GUJARAT,447,JAMNAGAR,6723,349,26,7098,2022-01-11
GUJARAT,448,JUNAGADH,5353,175,8,5536,2022-01-11
GUJARAT,449,KACHCHH,13166,1056,122,14344,2022-01-11
GUJARAT,450,KHEDA,4286,85,3,4374,2022-01-11
GUJARAT,451,MAHESANA,5850,346,24,6220,2022-01-11
GUJARAT,669,MAHISAGAR,663,15,0,678,2022-01-11
GUJARAT,673,MORBI,4795,280,11,5086,2022-01-11
GUJARAT,452,NARMADA,515,14,0,529,2022-01-11
GUJARAT,453,NAVSARI,3862,106,3,3971,2022-01-11
GUJARAT,454,PANCH MAHALS,2475,68,5,2548,2022-01-11
GUJARAT,455,PATAN,2023,83,2,2108,2022-01-11
GUJARAT,456,PORBANDAR,2289,105,4,2398,2022-01-11
GUJARAT,457,RAJKOT,24367,890,104,25361,2022-01-11
GUJARAT,458,SABAR KANTHA,4463,120,8,4591,2022-01-11
GUJARAT,459,SURAT,42869,1752,166,44787,2022-01-11
GUJARAT,460,SURENDRANAGAR,3247,119,6,3372,2022-01-11
GUJARAT,641,TAPI,1031,32,2,1065,2022-01-11
GUJARAT,461,VADODARA,29776,1103,118,30997,2022-01-11
GUJARAT,462,VALSAD,10776,410,19,11205,2022-01-11
HARYANA,58,AMBALA,6194,295,14,6503,2022-01-11
HARYANA,59,BHIWANI,5612,186,7,5805,2022-01-11
HARYANA,701,CHARKI DADRI,469,12,0,481,2022-01-11
HARYANA,60,FARIDABAD,17005,907,75,17987,2022-01-11
HARYANA,61,FATEHABAD,3955,132,5,4092,2022-01-11
HARYANA,62,GURUGRAM,21810,1846,252,23908,2022-01-11
HARYANA,63,HISAR,9981,414,29,10424,2022-01-11
HARYANA,64,JHAJJAR,4355,173,6,4534,2022-01-11
HARYANA,65,JIND,5610,228,11,5849,2022-01-11
HARYANA,66,KAITHAL,5295,137,5,5437,2022-01-11
HARYANA,67,KARNAL,10204,360,22,10586,2022-01-11
HARYANA,68,KURUKSHETRA,6138,229,8,6375,2022-01-11
HARYANA,69,MAHENDRAGARH,3101,98,3,3202,2022-01-11
HARYANA,604,NUH,2790,72,4,2866,2022-01-11
HARYANA,619,PALWAL,3853,137,5,3995,2022-01-11
HARYANA,70,PANCHKULA,4432,260,22,4714,2022-01-11
HARYANA,71,PANIPAT,8150,470,36,8656,2022-01-11
HARYANA,72,REWARI,4813,254,21,5088,2022-01-11
HARYANA,73,ROHTAK,4786,273,20,5079,2022-01-11
HARYANA,74,SIRSA,6113,229,13,6355,2022-01-11
HARYANA,75,SONIPAT,6604,262,13,6879,2022-01-11
HARYANA,76,YAMUNANAGAR,6686,257,11,6954,2022-01-11
HIMACHAL PRADESH,15,BILASPUR,911,24,2,937,2022-01-11
HIMACHAL PRADESH,16,CHAMBA,1020,16,0,1036,2022-01-11
HIMACHAL PRADESH,17,HAMIRPUR,1023,23,1,1047,2022-01-11
HIMACHAL PRADESH,18,KANGRA,3886,105,2,3993,2022-01-11
HIMACHAL PRADESH,19,KINNAUR,187,1,0,188,2022-01-11
HIMACHAL PRADESH,20,KULLU,1762,49,1,1812,2022-01-11
HIMACHAL PRADESH,21,LAHUL AND SPITI,125,0,0,125,2022-01-11
HIMACHAL PRADESH,22,MANDI,2571,67,3,2641,2022-01-11
HIMACHAL PRADESH,23,SHIMLA,2758,92,6,2856,2022-01-11
HIMACHAL PRADESH,24,SIRMAUR,1398,30,2,1430,2022-01-11
HIMACHAL PRADESH,25,SOLAN,4543,176,9,4728,2022-01-11
HIMACHAL PRADESH,26,UNA,1546,30,0,1576,2022-01-11
JHARKHAND,322,BOKARO ,7269,202,14,7485,2022-01-11
JHARKHAND,323,CHATRA,1453,22,1,1476,2022-01-11
JHARKHAND,324,DEOGHAR,2690,90,8,2788,2022-01-11
JHARKHAND,325,DHANBAD,9402,247,22,9671,2022-01-11
JHARKHAND,326,DUMKA,1591,43,5,1639,2022-01-11
JHARKHAND,327,EAST SINGHBHUM,9213,477,34,9724,2022-01-11
JHARKHAND,328,GARHWA ,922,25,0,947,2022-01-11
JHARKHAND,329,GIRIDIH,4967,54,4,5025,2022-01-11
JHARKHAND,330,GODDA,1365,32,2,1399,2022-01-11
JHARKHAND,331,GUMLA ,878,27,0,905,2022-01-11
JHARKHAND,332,HAZARIBAG ,5462,98,8,5568,2022-01-11
JHARKHAND,333,JAMTARA,842,10,0,852,2022-01-11
JHARKHAND,606,KHUNTI ,427,10,0,437,2022-01-11
JHARKHAND,334,KODERMA ,2195,40,2,2237,2022-01-11
JHARKHAND,335,LATEHAR,720,15,0,735,2022-01-11
JHARKHAND,336,LOHARDAGA ,747,20,0,767,2022-01-11
JHARKHAND,337,PAKUR ,1063,19,0,1082,2022-01-11
JHARKHAND,338,PALAMU,1614,47,3,1664,2022-01-11
JHARKHAND,607,RAMGARH ,3326,90,2,3418,2022-01-11
JHARKHAND,339,RANCHI ,13197,602,53,13852,2022-01-11
JHARKHAND,340,SAHEBGANJ,1219,34,1,1254,2022-01-11
JHARKHAND,341,SERAIKELA-KHARSAWAN  ,2218,95,9,2322,2022-01-11
JHARKHAND,342,SIMDEGA ,402,4,0,406,2022-01-11
JHARKHAND,343,WEST SINGHBHUM,1571,54,2,1627,2022-01-11
KARNATAKA,524,BAGALKOT,5649,115,4,5768,2022-01-11
KARNATAKA,528,BALLARI,6889,290,27,7206,2022-01-11
KARNATAKA,527,BELAGAVI,16594,307,16,16917,2022-01-11
KARNATAKA,526,BENGALURU (RURAL),13435,393,35,13863,2022-01-11
KARNATAKA,525,BENGALURU (URBAN),79909,5351,703,85963,2022-01-11
KARNATAKA,529,BIDAR,3446,80,2,3528,2022-01-11
KARNATAKA,531,CHAMARAJNAGAR,1813,40,2,1855,2022-01-11
KARNATAKA,630,CHIKBALLAPUR,2876,90,6,2972,2022-01-11
KARNATAKA,532,CHIKKAMAGALURU,3287,101,3,3391,2022-01-11
KARNATAKA,533,CHITRADURGA,3242,93,3,3338,2022-01-11
KARNATAKA,534,DAKSHIN KANNAD,10808,439,34,11281,2022-01-11
KARNATAKA,535,DAVANGERE,5371,168,7,5546,2022-01-11
KARNATAKA,536,DHARWAD,11771,370,29,12170,2022-01-11
KARNATAKA,537,GADAG,3119,77,1,3197,2022-01-11
KARNATAKA,539,HASSAN,5229,192,2,5423,2022-01-11
KARNATAKA,540,HAVERI,3726,119,2,3847,2022-01-11
KARNATAKA,538,KALABURAGI,4708,158,15,4881,2022-01-11
KARNATAKA,541,KODAGU,1911,51,3,1965,2022-01-11
KARNATAKA,542,KOLAR,3987,137,5,4129,2022-01-11
KARNATAKA,543,KOPPAL,2800,116,2,2918,2022-01-11
KARNATAKA,544,MANDYA,4626,111,2,4739,2022-01-11
KARNATAKA,545,MYSURU,12632,467,28,13127,2022-01-11
KARNATAKA,546,RAICHUR,4566,204,5,4775,2022-01-11
KARNATAKA,631,RAMANAGARA,3151,77,5,3233,2022-01-11
KARNATAKA,547,SHIVAMOGGA,6026,198,9,6233,2022-01-11
KARNATAKA,548,TUMAKURU,6760,215,11,6986,2022-01-11
KARNATAKA,549,UDUPI,5131,180,11,5322,2022-01-11
KARNATAKA,550,UTTAR KANNAD,5165,89,3,5257,2022-01-11
KARNATAKA,738,VIJAYANAGAR,0,0,0,0,2022-01-11
KARNATAKA,530,VIJAYAPURA,6759,179,11,6949,2022-01-11
KARNATAKA,635,YADGIR,3342,61,1,3404,2022-01-11
KERALA,554,ALAPPUZHA,6095,231,7,6333,2022-01-11
KERALA,555,ERNAKULAM,16436,1449,134,18019,2022-01-11
KERALA,556,IDUKKI,2715,152,6,2873,2022-01-11
KERALA,557,KANNUR,6393,260,27,6680,2022-01-11
KERALA,558,KASARAGOD,2682,116,3,2801,2022-01-11
KERALA,559,KOLLAM,6136,351,11,6498,2022-01-11
KERALA,560,KOTTAYAM,6022,341,25,6388,2022-01-11
KERALA,561,KOZHIKODE,8150,454,35,8639,2022-01-11
KERALA,562,MALAPPURAM,6803,315,24,7142,2022-01-11
KERALA,563,PALAKKAD,6866,269,20,7155,2022-01-11
KERALA,564,PATHANAMTHIPTA,3463,180,9,3652,2022-01-11
KERALA,565,THIRUVANANTHAPURAM,14650,577,48,15275,2022-01-11
KERALA,566,THRISSUR,9443,529,43,10015,2022-01-11
KERALA,567,WAYANAD,2256,81,5,2342,2022-01-11
MADHYA PRADESH,667,AGAR MALWA,1523,34,2,1559,2022-01-11
MADHYA PRADESH,639,ALIRAJPUR,520,9,0,529,2022-01-11
MADHYA PRADESH,390,ANUPPUR,1225,14,1,1240,2022-01-11
MADHYA PRADESH,391,ASHOKNAGAR,1273,48,4,1325,2022-01-11
MADHYA PRADESH,392,BALAGHAT,4691,64,2,4757,2022-01-11
MADHYA PRADESH,393,BARWANI,2363,79,1,2443,2022-01-11
MADHYA PRADESH,394,BETUL,3954,74,2,4030,2022-01-11
MADHYA PRADESH,395,BHIND,1923,28,1,1952,2022-01-11
MADHYA PRADESH,396,BHOPAL,14560,682,60,15302,2022-01-11
MADHYA PRADESH,397,BURHANPUR,1556,22,0,1578,2022-01-11
MADHYA PRADESH,398,CHHATARPUR,2517,76,2,2595,2022-01-11
MADHYA PRADESH,399,CHHINDWARA,6237,159,10,6406,2022-01-11
MADHYA PRADESH,400,DAMOH,2004,52,1,2057,2022-01-11
MADHYA PRADESH,401,DATIA,940,30,0,970,2022-01-11
MADHYA PRADESH,402,DEWAS,5217,111,1,5329,2022-01-11
MADHYA PRADESH,403,DHAR,5376,165,5,5546,2022-01-11
MADHYA PRADESH,404,DINDORI,922,7,0,929,2022-01-11
MADHYA PRADESH,405,EAST NIMAR,2476,82,4,2562,2022-01-11
MADHYA PRADESH,406,GUNA,3449,75,5,3529,2022-01-11
MADHYA PRADESH,407,GWALIOR,10190,440,29,10659,2022-01-11
MADHYA PRADESH,408,HARDA,1360,51,1,1412,2022-01-11
MADHYA PRADESH,409,HOSHANGABAD,2574,103,11,2688,2022-01-11
MADHYA PRADESH,410,INDORE,23051,1470,143,24664,2022-01-11
MADHYA PRADESH,411,JABALPUR,9146,383,32,9561,2022-01-11
MADHYA PRADESH,412,JHABUA,1312,37,1,1350,2022-01-11
MADHYA PRADESH,413,KATNI,3056,122,10,3188,2022-01-11
MADHYA PRADESH,414,KHARGONE,4157,135,2,4294,2022-01-11
MADHYA PRADESH,415,MANDLA,1843,24,0,1867,2022-01-11
MADHYA PRADESH,416,MANDSAUR,5668,131,6,5805,2022-01-11
MADHYA PRADESH,417,MORENA,2611,82,3,2696,2022-01-11
MADHYA PRADESH,418,NARSINGHPUR,2232,78,1,2311,2022-01-11
MADHYA PRADESH,419,NEEMUCH,3220,80,3,3303,2022-01-11
MADHYA PRADESH,722,NIWARI,138,4,0,142,2022-01-11
MADHYA PRADESH,420,PANNA,1483,17,0,1500,2022-01-11
MADHYA PRADESH,421,RAISEN,3085,106,1,3192,2022-01-11
MADHYA PRADESH,422,RAJGARH,4580,84,0,4664,2022-01-11
MADHYA PRADESH,423,RATLAM,4474,152,2,4628,2022-01-11
MADHYA PRADESH,424,REWA,5773,113,8,5894,2022-01-11
MADHYA PRADESH,425,SAGAR,4438,110,7,4555,2022-01-11
MADHYA PRADESH,426,SATNA,5063,185,12,5260,2022-01-11
MADHYA PRADESH,427,SEHORE,4660,99,3,4762,2022-01-11
MADHYA PRADESH,428,SEONI,2982,80,5,3067,2022-01-11
MADHYA PRADESH,429,SHAHDOL,2076,62,1,2139,2022-01-11
MADHYA PRADESH,430,SHAJAPUR,3311,85,1,3397,2022-01-11
MADHYA PRADESH,431,SHEOPUR,452,29,0,481,2022-01-11
MADHYA PRADESH,432,SHIVPURI,2109,83,1,2193,2022-01-11
MADHYA PRADESH,433,SIDHI,1521,29,2,1552,2022-01-11
MADHYA PRADESH,638,SINGRAULI,2154,62,3,2219,2022-01-11
MADHYA PRADESH,434,TIKAMGARH,1267,36,0,1303,2022-01-11
MADHYA PRADESH,435,UJJAIN,7736,226,7,7969,2022-01-11
MADHYA PRADESH,436,UMARIA,598,12,0,610,2022-01-11
MADHYA PRADESH,437,VIDISHA,3474,113,1,3588,2022-01-11
MAHARASHTRA,466,AHMEDNAGAR,34780,513,20,35313,2022-01-11
MAHARASHTRA,467,AKOLA,9412,157,10,9579,2022-01-11
MAHARASHTRA,468,AMRAVATI,13265,218,9,13492,2022-01-11
MAHARASHTRA,469,AURANGABAD,42870,649,57,43576,2022-01-11
MAHARASHTRA,470,BEED,11839,149,4,11992,2022-01-11
MAHARASHTRA,471,BHANDARA,5757,58,2,5817,2022-01-11
MAHARASHTRA,472,BULDHANA,12664,178,4,12846,2022-01-11
MAHARASHTRA,473,CHANDRAPUR,8434,231,13,8678,2022-01-11
MAHARASHTRA,474,DHULE,7573,149,11,7733,2022-01-11
MAHARASHTRA,475,GADCHIROLI,3200,47,1,3248,2022-01-11
MAHARASHTRA,476,GONDIA,6093,100,5,6198,2022-01-11
MAHARASHTRA,477,HINGOLI,4885,72,3,4960,2022-01-11
MAHARASHTRA,478,JALGAON,21436,391,23,21850,2022-01-11
MAHARASHTRA,479,JALNA,14195,196,15,14406,2022-01-11
MAHARASHTRA,480,KOLHAPUR,32599,538,57,33194,2022-01-11
MAHARASHTRA,481,LATUR,11678,238,10,11926,2022-01-11
MAHARASHTRA,482,MUMBAI ,69126,5366,942,75434,2022-01-11
MAHARASHTRA,483,MUMBAI SUBURBAN,84810,3535,512,88857,2022-01-11
MAHARASHTRA,484,NAGPUR,43168,1442,154,44764,2022-01-11
MAHARASHTRA,485,NAN DED,13293,205,15,13513,2022-01-11
MAHARASHTRA,486,NANDURBAR,3595,76,4,3675,2022-01-11
MAHARASHTRA,487,NASHIK,45613,1044,72,46729,2022-01-11
MAHARASHTRA,488,OSMANABAD,10009,83,1,10093,2022-01-11
MAHARASHTRA,665,PALGHAR,31054,341,23,31418,2022-01-11
MAHARASHTRA,489,PARBHANI,9521,103,5,9629,2022-01-11
MAHARASHTRA,490,PUNE,143132,3937,376,147445,2022-01-11
MAHARASHTRA,491,RAIGAD,38065,792,55,38912,2022-01-11
MAHARASHTRA,492,RATNAGIRI,11900,104,5,12009,2022-01-11
MAHARASHTRA,493,SANGLI,20215,374,18,20607,2022-01-11
MAHARASHTRA,494,SATARA,22910,270,15,23195,2022-01-11
MAHARASHTRA,495,SINDHUDURG,5424,38,1,5463,2022-01-11
MAHARASHTRA,496,SOLAPUR,31790,449,22,32261,2022-01-11
MAHARASHTRA,497,THANE,115435,2994,312,118741,2022-01-11
MAHARASHTRA,498,WARDHA,8016,85,6,8107,2022-01-11
MAHARASHTRA,499,WASHIM,5210,102,8,5320,2022-01-11
MAHARASHTRA,500,YAVATMAL,9554,143,7,9704,2022-01-11
MANIPUR,252,BISHNUPUR,934,9,0,943,2022-01-11
MANIPUR,253,CHANDEL,232,0,1,233,2022-01-11
MANIPUR,254,CHURACHANDPUR,506,4,0,510,2022-01-11
MANIPUR,255,IMPHAL EAST,2490,39,1,2530,2022-01-11
MANIPUR,256,IMPHAL WEST,3394,105,7,3506,2022-01-11
MANIPUR,713,JIRIBAM,17,0,0,17,2022-01-11
MANIPUR,711,KAKCHING,155,2,0,157,2022-01-11
MANIPUR,717,KAMJONG,22,0,0,22,2022-01-11
MANIPUR,712,KANGPOKPI,67,0,0,67,2022-01-11
MANIPUR,714,NONEY,14,0,0,14,2022-01-11
MANIPUR,715,PHERZAWL,1,0,0,1,2022-01-11
MANIPUR,257,SENAPATI,485,5,0,490,2022-01-11
MANIPUR,258,TAMENGLONG,112,0,0,112,2022-01-11
MANIPUR,716,TENGNOUPAL,22,0,0,22,2022-01-11
MANIPUR,259,THOUBAL,1359,11,0,1370,2022-01-11
MANIPUR,260,UKHRUL,241,0,0,241,2022-01-11
MEGHALAYA,273,EAST GARO HILLS,51,0,0,51,2022-01-11
MEGHALAYA,657,EAST JAINTIA HILLS,41,3,0,44,2022-01-11
MEGHALAYA,274,EAST KHASI HILLS,606,74,7,687,2022-01-11
MEGHALAYA,656,NORTH GARO HILLS,21,0,0,21,2022-01-11
MEGHALAYA,276,RI BHOI,126,4,2,132,2022-01-11
MEGHALAYA,277,SOUTH GARO HILLS,14,0,0,14,2022-01-11
MEGHALAYA,663,SOUTH WEST  GARO HILLS,84,1,0,85,2022-01-11
MEGHALAYA,658,SOUTH WEST KHASI HILLS,18,0,0,18,2022-01-11
MEGHALAYA,278,WEST GARO HILLS,217,5,2,224,2022-01-11
MEGHALAYA,275,WEST JAINTIA HILLS,78,1,0,79,2022-01-11
MEGHALAYA,279,WEST KHASI HILLS,30,1,0,31,2022-01-11
MIZORAM,261,AIZAWL,913,40,8,961,2022-01-11
MIZORAM,262,CHAMPHAI,217,3,0,220,2022-01-11
MIZORAM,726,Hnahthial,10,0,0,10,2022-01-11
MIZORAM,728,Khawzawl,42,0,0,42,2022-01-11
MIZORAM,263,KOLASIB,318,1,0,319,2022-01-11
MIZORAM,264,LAWNGTLAI,80,0,0,80,2022-01-11
MIZORAM,265,LUNGLEI,198,2,0,200,2022-01-11
MIZORAM,266,MAMIT,106,0,0,106,2022-01-11
MIZORAM,267,SAIHA,39,4,0,43,2022-01-11
MIZORAM,727,Saitual,26,0,0,26,2022-01-11
MIZORAM,268,SERCHHIP,53,2,0,55,2022-01-11
NAGALAND,244,DIMAPUR,855,18,2,875,2022-01-11
NAGALAND,614,KIPHRIE,24,0,0,24,2022-01-11
NAGALAND,245,KOHIMA,402,5,0,407,2022-01-11
NAGALAND,615,LONGLENG,6,0,0,6,2022-01-11
NAGALAND,246,MOKOKCHUNG,133,0,0,133,2022-01-11
NAGALAND,247,MON,96,0,0,96,2022-01-11
NAGALAND,736,Noklak,0,0,0,0,2022-01-11
NAGALAND,613,PEREN,57,0,0,57,2022-01-11
NAGALAND,248,PHEK,50,0,0,50,2022-01-11
NAGALAND,249,TUENSANG,12,0,0,12,2022-01-11
NAGALAND,250,WOKHA,76,0,0,76,2022-01-11
NAGALAND,251,ZUNHEBOTO,46,0,0,46,2022-01-11
ODISHA,344,ANGUL,3096,181,20,3297,2022-01-11
ODISHA,345,BALANGIR,2205,65,5,2275,2022-01-11
ODISHA,346,BALESHWAR,3851,147,9,4007,2022-01-11
ODISHA,347,BARGARH,2184,98,6,2288,2022-01-11
ODISHA,348,BHADRAK,2272,53,2,2327,2022-01-11
ODISHA,349,BOUDH,590,6,0,596,2022-01-11
ODISHA,350,CUTTACK,9020,438,43,9501,2022-01-11
ODISHA,351,DEOGARH,353,5,0,358,2022-01-11
ODISHA,352,DHENKANAL,2004,58,1,2063,2022-01-11
ODISHA,353,GAJAPATI,519,15,1,535,2022-01-11
ODISHA,354,GANJAM,7237,265,8,7510,2022-01-11
ODISHA,355,JAGATSINGHPUR,3430,115,4,3549,2022-01-11
ODISHA,356,JAJAPUR,3978,156,10,4144,2022-01-11
ODISHA,357,JHARSUGUDA,1974,128,7,2109,2022-01-11
ODISHA,358,KALAHANDI,1754,75,5,1834,2022-01-11
ODISHA,359,KANDHAMAL,939,10,0,949,2022-01-11
ODISHA,360,KENDRAPARA,2675,59,0,2734,2022-01-11
ODISHA,361,KENDUJHAR,4849,199,25,5073,2022-01-11
ODISHA,362,KHORDHA,12815,834,82,13731,2022-01-11
ODISHA,363,KORAPUT,1668,79,3,1750,2022-01-11
ODISHA,364,MALKANGIRI  ,838,23,0,861,2022-01-11
ODISHA,365,MAYURBHANJ,2676,84,0,2760,2022-01-11
ODISHA,366,NABARANGPUR,798,42,0,840,2022-01-11
ODISHA,367,NAYAGARH,1523,22,0,1545,2022-01-11
ODISHA,368,NUAPADA,738,20,0,758,2022-01-11
ODISHA,369,PURI,3894,61,1,3956,2022-01-11
ODISHA,370,RAYAGADA,1394,42,1,1437,2022-01-11
ODISHA,371,SAMBALPUR,2388,149,9,2546,2022-01-11
ODISHA,372,SONEPUR,895,14,0,909,2022-01-11
ODISHA,373,SUNDARGARH,4945,355,39,5339,2022-01-11
PUNJAB,27,AMRITSAR,10907,443,36,11386,2022-01-11
PUNJAB,605,BARNALA,2662,90,2,2754,2022-01-11
PUNJAB,28,BATHINDA,7470,351,22,7843,2022-01-11
PUNJAB,29,FARIDKOT,3151,80,2,3233,2022-01-11
PUNJAB,30,FATEHGARH SAHIB,2915,266,26,3207,2022-01-11
PUNJAB,651,FAZILKA,3991,115,9,4115,2022-01-11
PUNJAB,31,FIROZEPUR,3991,90,3,4084,2022-01-11
PUNJAB,32,GURDASPUR,3845,98,6,3949,2022-01-11
PUNJAB,33,HOSHIARPUR,6574,146,7,6727,2022-01-11
PUNJAB,34,JALANDHAR,14603,464,45,15112,2022-01-11
PUNJAB,35,KAPURTHALA,4563,99,7,4669,2022-01-11
PUNJAB,36,LUDHIANA,23565,1241,87,24893,2022-01-11
PUNJAB,737,MALERKOTLA,46,0,0,46,2022-01-11
PUNJAB,37,MANSA,2769,61,1,2831,2022-01-11
PUNJAB,38,MOGA,4802,119,5,4926,2022-01-11
PUNJAB,662,PATHANKOT,2203,76,1,2280,2022-01-11
PUNJAB,41,PATIALA,11242,320,17,11579,2022-01-11
PUNJAB,42,RUPNAGAR,2703,85,6,2794,2022-01-11
PUNJAB,43,SANGRUR,6649,203,5,6857,2022-01-11
PUNJAB,608,SAS NAGAR,14000,468,46,14514,2022-01-11
PUNJAB,40,SHAHID BHAGAT SINGH NAGAR,3026,54,0,3080,2022-01-11
PUNJAB,39,SRI MUKTSAR SAHIB,3612,116,4,3732,2022-01-11
PUNJAB,609,TARN TARAN,2425,36,0,2461,2022-01-11
RAJASTHAN,86,AJMER,17165,402,33,17600,2022-01-11
RAJASTHAN,87,ALWAR,15152,442,22,15616,2022-01-11
RAJASTHAN,88,BANSWARA,3332,61,3,3396,2022-01-11
RAJASTHAN,89,BARAN,2823,105,8,2936,2022-01-11
RAJASTHAN,90,BARMER,8176,233,8,8417,2022-01-11
RAJASTHAN,91,BHARATPUR,4560,127,7,4694,2022-01-11
RAJASTHAN,92,BHILWARA,13893,339,21,14253,2022-01-11
RAJASTHAN,93,BIKANER,15340,463,20,15823,2022-01-11
RAJASTHAN,94,BUNDI,3884,59,3,3946,2022-01-11
RAJASTHAN,95,CHITTORGARH,7951,233,11,8195,2022-01-11
RAJASTHAN,96,CHURU,7941,90,2,8033,2022-01-11
RAJASTHAN,97,DAUSA,5074,66,2,5142,2022-01-11
RAJASTHAN,98,DHOLPUR,1316,35,1,1352,2022-01-11
RAJASTHAN,99,DUNGARPUR,3518,45,2,3565,2022-01-11
RAJASTHAN,100,GANGANAGAR,12894,424,22,13340,2022-01-11
RAJASTHAN,101,HANUMANGARH,8965,180,8,9153,2022-01-11
RAJASTHAN,102,JAIPUR,71654,2475,254,74383,2022-01-11
RAJASTHAN,103,JAISALMER,2266,56,0,2322,2022-01-11
RAJASTHAN,104,JALORE,4821,83,1,4905,2022-01-11
RAJASTHAN,105,JHALAWAR,4032,99,4,4135,2022-01-11
RAJASTHAN,106,JHUNJHUNU,8526,125,6,8657,2022-01-11
RAJASTHAN,107,JODHPUR,22369,752,51,23172,2022-01-11
RAJASTHAN,108,KARAULI,2159,48,0,2207,2022-01-11
RAJASTHAN,109,KOTA,11127,509,45,11681,2022-01-11
RAJASTHAN,110,NAGAUR,12832,242,14,13088,2022-01-11
RAJASTHAN,111,PALI,8943,166,6,9115,2022-01-11
RAJASTHAN,629,PRATAPGARH,2420,23,0,2443,2022-01-11
RAJASTHAN,112,RAJSAMAND,4721,83,2,4806,2022-01-11
RAJASTHAN,113,SAWAI MADHOPUR,3355,80,1,3436,2022-01-11
RAJASTHAN,114,SIKAR,13272,220,10,13502,2022-01-11
RAJASTHAN,115,SIROHI,4786,68,4,4858,2022-01-11
RAJASTHAN,116,TONK,4233,112,3,4348,2022-01-11
RAJASTHAN,117,UDAIPUR,14906,507,42,15455,2022-01-11
SIKKIM,225,EAST DISTRICT,703,33,8,744,2022-01-11
SIKKIM,226,NORTH DISTRICT,44,1,0,45,2022-01-11
SIKKIM,227,SOUTH DISTRICT,180,3,0,183,2022-01-11
SIKKIM,228,WEST DISTRICT,146,2,0,148,2022-01-11
TAMIL NADU,610,ARIYALUR,3132,60,2,3194,2022-01-11
TAMIL NADU,730,Chengalpattu,6047,132,4,6183,2022-01-11
TAMIL NADU,568,CHENNAI,69731,4276,503,74510,2022-01-11
TAMIL NADU,569,COIMBATORE,35876,1266,119,37261,2022-01-11
TAMIL NADU,570,CUDDALORE,9962,207,10,10179,2022-01-11
TAMIL NADU,571,DHARMAPURI,7185,130,2,7317,2022-01-11
TAMIL NADU,572,DINDIGUL,10941,251,8,11200,2022-01-11
TAMIL NADU,573,ERODE,13380,489,24,13893,2022-01-11
TAMIL NADU,729,Kallakurichi,1732,29,1,1762,2022-01-11
TAMIL NADU,574,KANCHIPURAM,21780,548,44,22372,2022-01-11
TAMIL NADU,575,KANNIYAKUMARI,12296,259,8,12563,2022-01-11
TAMIL NADU,576,KARUR,4535,159,7,4701,2022-01-11
TAMIL NADU,577,KRISHNAGIRI,9433,354,11,9798,2022-01-11
TAMIL NADU,578,MADURAI,21491,598,41,22130,2022-01-11
TAMIL NADU,735,Maliyaduthurai,1475,21,0,1496,2022-01-11
TAMIL NADU,579,NAGAPATTINAM,4803,74,0,4877,2022-01-11
TAMIL NADU,580,NAMAKKAL,11489,469,40,11998,2022-01-11
TAMIL NADU,581,PERAMBALUR,2253,49,2,2304,2022-01-11
TAMIL NADU,582,PUDUKKOTTAI,7460,123,3,7586,2022-01-11
TAMIL NADU,583,RAMANATHAPURAM,4958,66,4,5028,2022-01-11
TAMIL NADU,731,Ranipet,1986,43,2,2031,2022-01-11
TAMIL NADU,584,SALEM,22107,715,36,22858,2022-01-11
TAMIL NADU,585,SIVAGANGA,6567,96,6,6669,2022-01-11
TAMIL NADU,733,Tenkasi,2711,62,0,2773,2022-01-11
TAMIL NADU,586,THANJAVUR,12320,281,15,12616,2022-01-11
TAMIL NADU,587,THE NILGIRISH,2295,35,4,2334,2022-01-11
TAMIL NADU,588,THENI,6413,131,8,6552,2022-01-11
TAMIL NADU,589,THIRUVALLUR,18941,526,35,19502,2022-01-11
TAMIL NADU,590,THIRUVARUR,5446,86,1,5533,2022-01-11
TAMIL NADU,591,TIRUCHIRAPPALLI,17030,427,26,17483,2022-01-11
TAMIL NADU,592,TIRUNELVELI,12292,269,11,12572,2022-01-11
TAMIL NADU,732,Tirupattu,1032,19,0,1051,2022-01-11
TAMIL NADU,634,TIRUPPUR,14546,566,18,15130,2022-01-11
TAMIL NADU,593,TIRUVANNAMALAI,8069,138,5,8212,2022-01-11
TAMIL NADU,594,TUTICORIN,9274,247,20,9541,2022-01-11
TAMIL NADU,595,VELLORE,10781,317,12,11110,2022-01-11
TAMIL NADU,596,VILLUPURAM,9932,213,7,10152,2022-01-11
TAMIL NADU,597,VIRUDHUNAGAR,9352,223,11,9586,2022-01-11
TELANGANA,501,ADILABAD,2259,54,4,2317,2022-01-11
TELANGANA,690,BHADRADRI KOTHAGUDEM,2303,46,2,2351,2022-01-11
TELANGANA,507,HYDERABAD,31524,3159,464,35147,2022-01-11
TELANGANA,681,Jagitial,2374,37,0,2411,2022-01-11
TELANGANA,689,JANGOAN,1370,19,1,1390,2022-01-11
TELANGANA,687,JAYASHANKAR BHUPALAPALLY,1095,16,2,1113,2022-01-11
TELANGANA,695,JOGULAMBA GADWAL,897,24,1,922,2022-01-11
TELANGANA,685,KAMAREDDY,2359,52,0,2411,2022-01-11
TELANGANA,508,KARIMNAGAR,7232,195,10,7437,2022-01-11
TELANGANA,509,KHAMMAM,4374,168,4,4546,2022-01-11
TELANGANA,699,KOMARAM BHEEM ASIFABAD,581,9,0,590,2022-01-11
TELANGANA,688,MAHABUBABAD,2084,34,1,2119,2022-01-11
TELANGANA,512,MAHABUBNAGAR,5223,89,7,5319,2022-01-11
TELANGANA,684,MANCHERIAL,2494,55,2,2551,2022-01-11
TELANGANA,513,MEDAK,2780,50,2,2832,2022-01-11
TELANGANA,700,MEDCHAL MALKAJGIRI,13700,714,56,14470,2022-01-11
TELANGANA,720,Mulugu,376,6,0,382,2022-01-11
TELANGANA,694,NAGARKURNOOL,1986,24,0,2010,2022-01-11
TELANGANA,514,NALGONDA,8626,102,6,8734,2022-01-11
TELANGANA,721,Narayanpet,385,10,0,395,2022-01-11
TELANGANA,680,Nirmal,1230,33,1,1264,2022-01-11
TELANGANA,516,NIZAMABAD,7418,158,3,7579,2022-01-11
TELANGANA,682,PEDDAPALLI,2726,71,2,2799,2022-01-11
TELANGANA,683,RAJANNA SIRCILLA,1629,17,1,1647,2022-01-11
TELANGANA,518,RANGA REDDI,18172,989,116,19277,2022-01-11
TELANGANA,691,SANGAREDDY,4259,109,3,4371,2022-01-11
TELANGANA,692,SIDDIPET,2518,56,5,2579,2022-01-11
TELANGANA,696,SURYAPET,4561,92,3,4656,2022-01-11
TELANGANA,698,VIKARABAD,1933,34,0,1967,2022-01-11
TELANGANA,693,WANAPARTHY,1154,22,0,1176,2022-01-11
TELANGANA,522,WARANGAL RURAL,2588,49,1,2638,2022-01-11
TELANGANA,686,WARANGAL URBAN,6051,263,16,6330,2022-01-11
TELANGANA,697,YADADRI BHUVANAGIRI,2551,27,0,2578,2022-01-11
TRIPURA,269,DHALAI,221,3,1,225,2022-01-11
TRIPURA,654,GOMATI,344,10,0,354,2022-01-11
TRIPURA,652,KHOWAI,180,2,0,182,2022-01-11
TRIPURA,270,NORTH TRIPURA,440,20,0,460,2022-01-11
TRIPURA,653,SEPAHIJALA,272,5,0,277,2022-01-11
TRIPURA,271,SOUTH TRIPURA,287,10,0,297,2022-01-11
TRIPURA,655,UNAKOTI,275,2,0,277,2022-01-11
TRIPURA,272,WEST TRIPURA,1537,111,8,1656,2022-01-11
UTTAR PRADESH,118,AGRA,14557,589,51,15197,2022-01-11
UTTAR PRADESH,119,ALIGARH,5597,201,13,5811,2022-01-11
UTTAR PRADESH,121,AMBEDAKAR NAGAR,2179,60,3,2242,2022-01-11
UTTAR PRADESH,640,AMETHI,2109,42,0,2151,2022-01-11
UTTAR PRADESH,154,AMROHA,1818,68,2,1888,2022-01-11
UTTAR PRADESH,122,AURAIYA,1316,38,0,1354,2022-01-11
UTTAR PRADESH,123,AZAMGARH,5441,75,3,5519,2022-01-11
UTTAR PRADESH,124,BAGHPAT,2761,27,0,2788,2022-01-11
UTTAR PRADESH,125,BAHRAICH,2169,119,1,2289,2022-01-11
UTTAR PRADESH,126,BALLIA,2878,71,1,2950,2022-01-11
UTTAR PRADESH,127,BALRAMPUR,1378,34,1,1413,2022-01-11
UTTAR PRADESH,128,BANDA,1384,39,1,1424,2022-01-11
UTTAR PRADESH,129,BARABANKI,3282,96,8,3386,2022-01-11
UTTAR PRADESH,130,BAREILLY,8337,347,36,8720,2022-01-11
UTTAR PRADESH,131,BASTI,2356,69,3,2428,2022-01-11
UTTAR PRADESH,179,BHADOHI,2470,34,2,2506,2022-01-11
UTTAR PRADESH,132,BIJNOR,2771,75,8,2854,2022-01-11
UTTAR PRADESH,133,BUDAUN,2302,72,1,2375,2022-01-11
UTTAR PRADESH,134,BULANDSHAHAR,4585,131,6,4722,2022-01-11
UTTAR PRADESH,135,CHANDAULI,2252,60,4,2316,2022-01-11
UTTAR PRADESH,136,CHITRAKOOT,1044,17,0,1061,2022-01-11
UTTAR PRADESH,137,DEORIA,4016,69,2,4087,2022-01-11
UTTAR PRADESH,138,ETAH,1619,84,4,1707,2022-01-11
UTTAR PRADESH,139,ETAWAH,1779,54,5,1838,2022-01-11
UTTAR PRADESH,140,FAIZABAD,3198,105,7,3310,2022-01-11
UTTAR PRADESH,141,FARRUKHABAD,1707,46,1,1754,2022-01-11
UTTAR PRADESH,142,FATEHPUR,2712,80,1,2793,2022-01-11
UTTAR PRADESH,143,FIROZABAD,3302,79,5,3386,2022-01-11
UTTAR PRADESH,144,GAUTAM BUDDHA NAGAR,19320,1108,124,20552,2022-01-11
UTTAR PRADESH,145,GHAZIABAD,21095,940,109,22144,2022-01-11
UTTAR PRADESH,146,GHAZIPUR,5090,48,1,5139,2022-01-11
UTTAR PRADESH,147,GONDA,2804,102,4,2910,2022-01-11
UTTAR PRADESH,148,GORAKHAPUR,7403,341,27,7771,2022-01-11
UTTAR PRADESH,149,HAMIRPUR,1132,31,0,1163,2022-01-11
UTTAR PRADESH,661,HAPUR,3025,103,8,3136,2022-01-11
UTTAR PRADESH,150,HARDOI,3734,108,5,3847,2022-01-11
UTTAR PRADESH,163,HATHRAS,2395,63,2,2460,2022-01-11
UTTAR PRADESH,151,JALAUN,1268,43,2,1313,2022-01-11
UTTAR PRADESH,152,JAUNPUR,6205,81,2,6288,2022-01-11
UTTAR PRADESH,153,JHANSI,4675,218,12,4905,2022-01-11
UTTAR PRADESH,155,KANNAUJ,1470,32,0,1502,2022-01-11
UTTAR PRADESH,156,KANPUR DEHAT,1788,34,1,1823,2022-01-11
UTTAR PRADESH,157,KANPUR NAGAR,13411,818,98,14327,2022-01-11
UTTAR PRADESH,633,KASGANJ,932,29,1,962,2022-01-11
UTTAR PRADESH,158,KAUSHAMBI,1530,28,0,1558,2022-01-11
UTTAR PRADESH,160,KUSHINAGAR,2829,81,5,2915,2022-01-11
UTTAR PRADESH,159,LAKHIMPUR KHERI,3511,148,8,3667,2022-01-11
UTTAR PRADESH,161,LALITPUR,1166,45,4,1215,2022-01-11
UTTAR PRADESH,162,LUCKNOW,26146,1247,125,27518,2022-01-11
UTTAR PRADESH,164,MAHARAJGANJ,2335,62,2,2399,2022-01-11
UTTAR PRADESH,165,MAHOBA,839,20,1,860,2022-01-11
UTTAR PRADESH,166,MAINPURI,1854,59,3,1916,2022-01-11
UTTAR PRADESH,167,MATHURA,8683,192,10,8885,2022-01-11
UTTAR PRADESH,168,MAU,2263,28,2,2293,2022-01-11
UTTAR PRADESH,169,MEERUT,10753,361,24,11138,2022-01-11
UTTAR PRADESH,170,MIRZAPUR,2810,77,3,2890,2022-01-11
UTTAR PRADESH,171,MORADABAD,5848,223,16,6087,2022-01-11
UTTAR PRADESH,172,MUZAFFARNAGAR,5623,227,16,5866,2022-01-11
UTTAR PRADESH,173,PILIBHIT,2348,57,2,2407,2022-01-11
UTTAR PRADESH,174,PRATAPGARH,3878,66,2,3946,2022-01-11
UTTAR PRADESH,120,PRAYAGRAJ,10580,355,28,10963,2022-01-11
UTTAR PRADESH,175,RAE BARELI,3543,64,5,3612,2022-01-11
UTTAR PRADESH,176,RAMPUR,2958,70,2,3030,2022-01-11
UTTAR PRADESH,177,SAHARANPUR,6779,157,8,6944,2022-01-11
UTTAR PRADESH,659,SAMBHAL,1658,50,2,1710,2022-01-11
UTTAR PRADESH,178,SANT KABEER NAGAR,1656,33,2,1691,2022-01-11
UTTAR PRADESH,180,SHAHJAHANPUR,2625,118,10,2753,2022-01-11
UTTAR PRADESH,660,SHAMLI,1700,45,0,1745,2022-01-11
UTTAR PRADESH,181,SHRAVASTI,652,12,0,664,2022-01-11
UTTAR PRADESH,182,SIDDHARTHNAGAR,1581,30,2,1613,2022-01-11
UTTAR PRADESH,183,SITAPUR,3078,112,4,3194,2022-01-11
UTTAR PRADESH,184,SONBHADRA,2715,100,5,2820,2022-01-11
UTTAR PRADESH,185,SULTANPUR,2457,86,1,2544,2022-01-11
UTTAR PRADESH,186,UNNAO,2558,60,0,2618,2022-01-11
UTTAR PRADESH,187,VARANASI,12023,474,57,12554,2022-01-11
UTTARAKHAND,45,ALMORA,1690,12,0,1702,2022-01-11
UTTARAKHAND,46,BAGESHWAR,568,3,1,572,2022-01-11
UTTARAKHAND,47,CHAMOLI,1016,8,0,1024,2022-01-11
UTTARAKHAND,48,CHAMPAWAT,525,10,1,536,2022-01-11
UTTARAKHAND,49,DEHRADUN,13422,462,39,13923,2022-01-11
UTTARAKHAND,50,HARIDWAR,6181,220,9,6410,2022-01-11
UTTARAKHAND,51,NAINITAL,3988,174,13,4175,2022-01-11
UTTARAKHAND,52,PAURI GARHWAL,1531,29,0,1560,2022-01-11
UTTARAKHAND,53,PITHORAGARH,1010,18,0,1028,2022-01-11
UTTARAKHAND,54,RUDRA PRAYAG,852,4,0,856,2022-01-11
UTTARAKHAND,55,TEHRI GARHWAL,1698,20,3,1721,2022-01-11
UTTARAKHAND,56,UDHAM SINGH NAGAR,6214,273,13,6500,2022-01-11
UTTARAKHAND,57,UTTARKASHI,1027,4,0,1031,2022-01-11
WEST BENGAL,664,ALIPURDUAR,1122,44,3,1169,2022-01-11
WEST BENGAL,305,BANKURA,2447,103,5,2555,2022-01-11
WEST BENGAL,307,BIRBHUM,2732,103,4,2839,2022-01-11
WEST BENGAL,308,COOCHBEHAR,2462,88,2,2552,2022-01-11
WEST BENGAL,310,DAKSHIN DINAJPUR,1496,46,1,1543,2022-01-11
WEST BENGAL,309,DARJEELING,4263,442,34,4739,2022-01-11
WEST BENGAL,317,EAST MEDINIPUR,6654,315,18,6987,2022-01-11
WEST BENGAL,312,HOOGHLY,5744,289,10,6043,2022-01-11
WEST BENGAL,313,HOWRAH,6443,431,22,6896,2022-01-11
WEST BENGAL,314,JALPAIGURI,2990,135,10,3135,2022-01-11
WEST BENGAL,703,Jhargram,517,16,0,533,2022-01-11
WEST BENGAL,702,KALIMPONG,235,10,0,245,2022-01-11
WEST BENGAL,315,KOLKOTA,18192,3226,500,21918,2022-01-11
WEST BENGAL,316,MALDA,3605,127,11,3743,2022-01-11
WEST BENGAL,319,MURSHIDABAD,5872,218,10,6100,2022-01-11
WEST BENGAL,320,NADIA,4741,159,9,4909,2022-01-11
WEST BENGAL,303,NORTH 24 PRAGANAS,14317,679,55,15051,2022-01-11
WEST BENGAL,704,PASCHIM BARDHAMAN,5785,389,28,6202,2022-01-11
WEST BENGAL,306,PURBA BARDHAMAN,4514,226,5,4745,2022-01-11
WEST BENGAL,321,PURULIA,1546,62,3,1611,2022-01-11
WEST BENGAL,304,SOUTH 24 PRAGANAS,8504,256,23,8783,2022-01-11
WEST BENGAL,311,UTTAR DINAJPUR,2537,130,6,2673,2022-01-11
WEST BENGAL,318,WEST MEDINIPUR,5138,163,13,5314,2022-01-11
ANDAMAN AND NICOBAR ISLANDS,603,NIKOBARS,121,2,0,123,2022-01-11
ANDAMAN AND NICOBAR ISLANDS,632,NORTH AND MIDDLE ANDAMAN,276,4,0,280,2022-01-11
ANDAMAN AND NICOBAR ISLANDS,602,SOUTH ANDAMANS,2487,105,6,2598,2022-01-11
CHANDIGARH,44,CHANDIGARH,9010,687,76,9773,2022-01-11
DADAR AND NAGAR HAVELI,465,DADRA AND NAGAR HAVELLI,2511,98,3,2612,2022-01-11
DAMAN AND DIU,463,DAMAN,811,29,2,842,2022-01-11
DAMAN AND DIU,464,DIU,81,6,0,87,2022-01-11
DELHI,77,CENTRAL,6410,1221,164,7795,2022-01-11
DELHI,78,EAST,12953,953,102,14008,2022-01-11
DELHI,79,NEW DELHI,7872,894,157,8923,2022-01-11
DELHI,80,NORTH,5813,846,114,6773,2022-01-11
DELHI,81,NORTH EAST,6341,286,46,6673,2022-01-11
DELHI,82,NORTH WEST,17989,1433,238,19660,2022-01-11
DELHI,671,SHAHDARA,1401,85,8,1494,2022-01-11
DELHI,83,SOUTH ,15580,1856,265,17701,2022-01-11
DELHI,670,SOUTH EAST,3701,294,34,4029,2022-01-11
DELHI,84,SOUTH WEST,13882,1150,128,15160,2022-01-11
DELHI,85,WEST,14657,1062,143,15862,2022-01-11
JAMMU AND KASHMIR,1,ANANTNAG,7281,94,1,7376,2022-01-11
JAMMU AND KASHMIR,2,BADGAM,3273,31,1,3305,2022-01-11
JAMMU AND KASHMIR,623,BANDIPORA,912,6,1,919,2022-01-11
JAMMU AND KASHMIR,3,BARAMULLA,3131,34,2,3167,2022-01-11
JAMMU AND KASHMIR,4,DODA,1393,11,0,1404,2022-01-11
JAMMU AND KASHMIR,626,GANDERBAL,1651,13,2,1666,2022-01-11
JAMMU AND KASHMIR,5,JAMMU,5949,511,31,6491,2022-01-11
JAMMU AND KASHMIR,7,KATHUA,2194,31,1,2226,2022-01-11
JAMMU AND KASHMIR,620,KISHTWAR,1456,9,0,1465,2022-01-11
JAMMU AND KASHMIR,622,KULGAM,1870,13,1,1884,2022-01-11
JAMMU AND KASHMIR,8,KUPWARA,1666,7,0,1673,2022-01-11
JAMMU AND KASHMIR,10,POONCH,1343,18,1,1362,2022-01-11
JAMMU AND KASHMIR,11,PULWAMA,2913,46,7,2966,2022-01-11
JAMMU AND KASHMIR,12,RAJAURI,1832,26,1,1859,2022-01-11
JAMMU AND KASHMIR,621,RAMBAN,1421,8,0,1429,2022-01-11
JAMMU AND KASHMIR,627,REASI,876,19,0,895,2022-01-11
JAMMU AND KASHMIR,624,SAMBA,741,32,2,775,2022-01-11
JAMMU AND KASHMIR,625,SHOPIAN,1158,9,3,1170,2022-01-11
JAMMU AND KASHMIR,13,SRINAGAR,5097,193,7,5297,2022-01-11
JAMMU AND KASHMIR,14,UDHAMPUR,1277,34,1,1312,2022-01-11
LADAKH,6,KARGIL,553,9,0,562,2022-01-11
LADAKH,9,LEH LADAKH,1099,23,0,1122,2022-01-11
LAKSHADWEEP,553,LAKSHADWEEP DISTRICT,114,0,0,114,2022-01-11
PUDUCHERRY,598,KARAIKAL,989,47,1,1037,2022-01-11
PUDUCHERRY,599,MAHE,71,11,0,82,2022-01-11
PUDUCHERRY,600,PONDICHERRY,5577,202,21,5800,2022-01-11
PUDUCHERRY,601,YANAM,65,6,0,71,2022-01-11